10 10 8 6 0 0
9 8 8 8 8 8 8 12 9 12 
5 5 1 0 2 2 2 2 4 5 
7 7 5 5 9 8 12 13 7 7 
13 9 2 2 6 7 5 1 10 14 
3 2 12 13 9 8 0 0 8 12 
13 9 0 0 0 4 7 7 1 4 
5 5 5 5 1 0 10 10 0 4 
3 2 2 2 4 5 9 8 2 4 
9 8 10 14 5 1 0 0 10 6 
3 2 10 10 6 3 2 2 10 14 
