10 10 1 3 9 9
9 12 13 11 8 8 12 13 9 12
3 2 2 8 0 2 2 0 6 7
9 14 9 0 0 8 10 4 11 14
1 12 3 6 1 4 9 0 14 13
1 4 9 8 0 2 0 4 15 5
5 1 0 4 1 10 2 4 9 6
1 4 5 1 0 14 13 5 5 13
7 5 5 1 6 15 5 1 0 6
9 0 2 4 9 12 7 1 4 13
7 3 10 2 6 7 15 7 3 6
